#####
#   #
# # #
# # #
#O#X#
